agapmain=Application_Manipulation
agbgmain=Agent_Bugs
aglgmain=Networking
agsbmain=agsbmain
agsfmain=Fusion_Security
agssmain=ESS_User_Provisioning
agsymain=Security
apbgmain=API_Bugs
apgdmain=Grid_API
apgemain=General_API
apotmain=Outline_API
capitest=capitest
dcbgmain=Distributed_Cube_Bugs
dcmpmain=Mixed_Partitions
dcosmain=Outline_Synchronization
dcrpmain=Replicated_Partitions
dctpmain=Transparent_Partitions
ddbgmain=Data_Definition_Bugs
ddldmain=Data_Loader
ddximain=Export_Import
dmbgmain=Data_Manipulation_Bugs
dmccmain=Calculator
dmdcmain=Dynamic_Calculator
dmglmain=Fusion_GL
dmpcmain=Parallel_Calc
dmudmain=CDM_CDF_UDM_UDF
dresmain=Miscellaneous_Bugs
dsapbg=APS_Bugs
dsapdq_reg_v2=Additional_DataQuery_Packages
dsapds_reg_v1=Additional_DataSource_Packages1
dsapds_reg_v2=Additional_DataSource_Packages2
dsapfusion=dsapfusion
dsapmd_reg_v2=Additional_MetaData_Packages
dsapprobmain=dsapprobmain
dsapssdqmd_acc_v1=Session_DataQuery_MetaData_Packages
dxbgmain=Data_Extraction_Bugs
dxmdmain=MDX
dxrrmain=Report_Writer
dxssmain=Spreadsheet_Extractor
i18n_i=I18N_Acceptance_UtoU
i18n_i_slc=I18N_Acceptance_UtoN
i18n_j=I18N_Acceptance_NtoN
i18n_j_mlc=I18N_Acceptance_NtoU
i18n_x=I18N_Extended_Cross
i18n_xas=i18n_xas
maxlmain=Maxl_Tests
msscmain=EssCmd
prob_main=prob_main
regress_pb=regress_pb
regress_pd=regress_pd
regress_sb=regress_sb
regress_sd=regress_sd
sdatmain=Attributes
sdbgmain=Scheme_Definition_Bugs
sddbmain=Dimension_Build
sdremain=Schema_Manipulation
sdsvmain=Substitution_Variables
smalmain=Allocation_Manager
smbgmain=Storage_Manager_Bugs
smbumain=Backup
smixmain=Index_Manager
smlrmain=LRO
smtxmain=Transaction_Manager
